111111111111111111111111111
1CCCCCCCCCCCC1CCCCCCCCCCCC1
1C1111C11111C1C11111C1111C1
1CCCCCCCCCCCCCCCCCCCCCCCCC1
1C1111C1C111111111C1C1111C1
1CCCCCC1CCCCC1CCCCC1CCCCCC1
1000000000000000000000000E1
1000000000000P0000000000001
1CCCCCC1CCCCC1CCCCC1CCCCCC1
1C1111C1C111111111C1C1111C1
1CCCCCCCCCCCCCCCCCCCCCCCCC1
1C1111C11111C1C11111C1111C1
1CCCCCCCCCCCC1CCCCCCCCCCCC1
111111111111111111111111111