111111111111
1PCCCCCCC0E1
111111111111