111111111111
1C1C0CC00CC1
10C0E1CCP111
111111111111
