11111111111111111111
1CCCC1CCCCCCCC1CCCC1
1C10C1C111111C1C1C11
1C1CCCCPCCCCCCCCC1C1
1C1C11C110011C11C1C1
1C1C11C111111C11C1C1
1C1CCCCC00CCCCCC1C11
1C10C1C111111C1C11C1
1CC0C1CCCCCCCC1CCCC1
11101111111111111111
1CCCC1CCCCCCCC1CCCC1
1C10C1C111111C1C1C11
1C1CCCCCCCCCECCCC1C1
1C1C11C110011C11C1C1
1C1C11C111111C11C1C1
1C1CCCCC00CCCCCC1C11
1C10C1C111111C1C11C1
1CCCC1CCCCCCCC1CCCC1
11101111111111111111
11101111111111111111
1CCCC1CCCCCCCC1CCCC1
1C10C1C111111C1C1C11
1C1CCCCCCCCCCCCCC1C1
1C1C11C110011C11C1C1
1C1C11C111111C11C1C1
1C1CCCCC00CCCCCC1C11
1C10C1C111111C1C11C1
1CCCC1CCCCCCCC1CCCC1
11101111111111111111
11101111111111111111
1CCCC1CCCCCCCC1CCCC1
1C10C1C111111C1C1C11
1C1CCCCCCCCCCCCCC1C1
1C1C11C110011C11C1C1
1C1C11C111111C11C1C1
1C1CCCCC00CCCCCC1C11
1C10C1C111111C1C11C1
1CCCC1CCCCCCCC1CCCC1
11111111111111111111