111111111111
1PCCCCCCCCE1
111111111111