111111111111
1C1C0CC00CC0
10C001CCP111
1EC000100001
111111111111
