111111111111
1PCCCC1CCCE1
111111111111
