111111111111
1PCCCCCCC1E1
111111111111
