111111111111
1C1C0CC00CC1
11C0E1CCP111
10C000100001
111111111111